athlete_id,athlete_name,test_date,attempt_number,standing_reach_in,touch_height_in,vertical_jump_in
7aaf173e,John Smith,2025-07-20,1,93,123,30
7aaf173e,John Smith,2025-07-20,2,93,119,26
7aaf173e,John Smith,2025-07-20,3,93,126,33
3211fcb6,Mike Johnson,2025-06-30,1,85,114,29
3211fcb6,Mike Johnson,2025-06-30,2,85,117,32
3211fcb6,Mike Johnson,2025-06-30,3,85,108,23
dc008e57,David Lee,2025-07-16,1,87,115,28
dc008e57,David Lee,2025-07-16,2,87,114,27
16f90d54,Chris Anderson,2025-07-16,1,85,121,36
16f90d54,Chris Anderson,2025-07-16,2,85,110,25
16f90d54,Chris Anderson,2025-07-16,3,85,109,24
7a298462,James Brown,2025-07-24,1,95,117,22
7a298462,James Brown,2025-07-24,2,95,119,24
de1c65c9,Robert Davis,2025-06-29,1,89,123,34
de1c65c9,Robert Davis,2025-06-29,2,89,119,30
de1c65c9,Robert Davis,2025-06-29,3,89,112,23
7e3cad8b,Daniel Wilson,2025-07-21,1,90,122,32
7e3cad8b,Daniel Wilson,2025-07-21,2,90,116,26
fd2704bd,Anthony Garcia,2025-07-20,1,91,120,29
fd2704bd,Anthony Garcia,2025-07-20,2,91,116,25
fd2704bd,Anthony Garcia,2025-07-20,3,91,125,34
4021ef9e,Kevin Martinez,2025-07-22,1,91,121,30
4021ef9e,Kevin Martinez,2025-07-22,2,91,117,26
4021ef9e,Kevin Martinez,2025-07-22,3,91,127,36
3bde8f9f,William Clark,2025-06-26,1,86,109,23
3bde8f9f,William Clark,2025-06-26,2,86,122,36
3bde8f9f,William Clark,2025-06-26,3,86,115,29
